1 13 31
###############################
#p  *     *  1 *   *  * * *   #
# # # #*# # #*#*# # # #*#*#*# #
#   * *   ***  *      * 2 * * #
#*# # # # #*# # #*#*# # # # #*#
#   b   *  * **  *  *    1    #
# # # # # # # # # #*# #*# # # #
#*  *  s   *  *      *      * #
#f# # # #*# # # #*#*# # # # # #
#*    **  *       *   *   *   #
# #*# # # # # # #*# # # # # # #
#   b 1 *   *   *  *    x   * #
###############################