18 32
################################
#p     ** *  1 * 2    * * *    #
# # # #*# # #*#*# # # #*#*#*# ##
#  x*     ***  *  1     2 * * ##
# # # # # #*# # #*# # # # # #* #
#f          #           1     ##
# # # # # # # # # #*# #*# # #  #
#*  *      *  *      *      *  #
# # # # #*# # # #*#*# # # # #  #
#*    **  *       *        *   #
# # # # #*# # # #*#*# # # # #  #
#    *        *      *   *     #
# # # # #*# # # #*#*# # # # # ##
# *      *      *       *     *#
# # # # #*# # # #*#*# # # # #  #
# #       #    *      *     #  #
#   # #     *   *  *  #  *     #
################################
