5 13 31
###############################
#p#f   1#       # ###  b##  #3#
# ##  ### ###*# # f## ##### s #
#      #  #     #  ## #     # #
# #*## #### ## ###  #   ## ## #
# # #  #    #    # ###4##   # #
### * ## ####  #f#        ### #
# s #       # ##### *####  #  #
# # ####### #  #       ##### ##
# # * #   # ##4# #####  #     #
# # *#### # #### # s*# ## #  2#
# * b  1*        #        #2 x#
###############################