2 13 31
###############################
#p  #*x** *  b *   *  * * *  *#
#   ##### # #3#*# # # #*#*#*###
#   b     ***  1  #   *   * * #
###*# * # #*##*##***#  *f*#####
# * * # s   # 4 #*  *  *2 * * #
# # # # #   * # * #*#  *  # # #
# *   f    ## * #   #* #    * #
# # #   #*####*##*###*###*#*###
# # * **  *2#     #   *   *   #
# #1# # # ### ###*# # 3 # f * #
# f *   s   *   * **      *   #
###############################