2 13 31
###############################
#p 1   ** *  1 * 2 *  * * *   #
# # # #*# # #*#*# # # #*#*#*# #
#  x*  f  ***  * 1    * 2 * * #
# # # # # #*# # #*#*# # # # #*#
#f  b  s   x **  *  *    1    #
# # # # # # # # # #*# #*# # # #
#*  *  s   *  *      *        #
# # # # #*# # # #*#*# # # # # #
#*    **  *       *           #
# #*# # # # # # #*# # # # # # #
#   b       *   *  *          #
###############################