1 13 31
###############################
#p  *     *  1 * 2 *  * * *   #
# # # #*# # #*#*# # # #*#*#*# #
#   * *   ***  *      * 2 * * #
#*# # # # #*# # #*#*# # # # #*#
#   b   *  * **  *  *    1    #
# # # # # # # # # #*# #*# # # #
#*  *  s   * 3*      *      * #
#f# # # #*# # # #*#*# # # # # #
#*    **  *       * 1 *   * 2 #
# #*# # # # # # #*# # # # # # #
#   b 1 *   *   *  *    x   * #
###############################