3 13 31
###############################
#p                  1         #
# ###*#f#*####*b*####*#*#*### #
# #         2               # #
# # ######b*#######**###### # #
# * #   *     #*#     *   # * #
# # * b 4  #  *x*  #  4 s *2#1#
# s #   *     #*#     *   # * #
# # ######**#######**###### # #
# #             3           # #
# ###*#*#*####***####*#f#*### #
#     1                       #
###############################