4 13 31
###############################
#p b****s   #     #   *****s  #
#  #*#*#              1#*#*#  #
#  #*#*        1        s#*#  #
#  #*#*#             1 #*#*#  #
#  ***      #  f  #     *b*   #
#############*****#############
#     #                #   3  #
#  #*****f******b*****f****#  #
#* ##     5    #          ## *#
#   * ################### *   #
#  2*        **x**   4    *2  #
###############################