4 13 31
###############################
#p b**                   **s  #
#  #*                    1*#  #
#  #           1           #  #
#  #*                   1 *#  #
#  ***         f        *b*   #
#############*****#############
#     #                #   3  #
#  s*****f******b*****f*****  #
#* ##     4               ## *#
#   * ################### *   #
#  2*        **x**        *2  #
###############################