3 13 31
###############################
#p                  1         #
# ###*#f#*####*b*####*#*#*### #
# #         2           5   # #
# # ######b*#######**###### # #
# * #   *     #*#     *   # * #
# # * b 4  #  *x*  #    s *2# #
# s #   *     #*#     *   # * #
# # ######**#######**###### # #
# #             3           # #
# ###*#*#*####***####*#f#*### #
#     1                       #
###############################